111111111111111
100000000000001
100000000000001
100000000010001
100000000010001
100000N00010001
100000000010001
100000000010001
100000000010001
111111111111111