WE textures/greystone.xpm
SO textures/bluestone.xpm
EA textures/purplestone.xpm
NO textures/eagle.xpm

F 0, 255, 0
C 255, 255, 0

1111111111111111111111111111111111111111111111111111111111111111111111
11000000000000111110111100000000000000000000000000000000000000000000011
1111111111110101 1011110100011111111111111111111111111111111111111111111
        1111011111111111111011111
        1000000000110000000000001
        1011000000110000000000011
111111111001000000000000S00000001
111111111011000001110000000000001
100000000011000001110111111111111
11110111111111011100000010001
11110111111111011101000000001
11000000110101011101111111111
1000000001000000110001   101
1000000000000000110111   101
1000000001000000110001   101
11000001110101011111011111011
11110111 1110101 101000000001
1111111111111111111111111111111111111111111111111111111111111111111111111