EA textures/redbrick.xpm
SO textures/bluestone.xpm
EA textures/purplestone.xpm
NO textures/eagle.xpm

F 220,100,0
C 225,30,0






        1111111111111111111111111
        1000000000110000000000001
        1011000000110000000000011
111111111001000000000000000000001
111111111011000001110000000000001
100000000011000001110111111111111
11110111111111011100000010001
11110111111111011101000000001
1100N000110101011101111111111
11111111111111111111