1111111
1110001
100N001
1110001
1111111